000000001E000112
0111111011100110
0100100000101110
0100000000001E00
0101100000101100
0100111011101101
0100110000100001
0101100010001111
0101001011100000
0100011000111110
010101E01E000000
0101010111010111
0101000100010000
01000101011101E0
0101110000010110
P1E000001E000000