1111011111111111
P000000011111111
1111011011111111
0001110000111111
0000000000111111
0001110000111111
1111110000111111
1211111001111101
1011111001111101
10111110011111E1
0000111001110000
0000000000000000
0000000000000000
0000111111110000
1111111111111111
1111111111111111