1121111111111111
1101111111111111
1101110000000111
1101110001000111
1000011011101111
1000000000000000
1000000000000000
1000E110111011E0
1111110001000100
111111E000000100
1000011111111100
1000000000000000
1000000000000000
1000011011101111
1101110001000111
11P1110000000111