1111000000000101
1E00000111000000
10110000000001E1
1011111111101111
0001110111101111
0000000011101111
0001110111101111
1011110111E00011
1011110111000002
1011110111000011
0001110111000011
0000000011101111
0001110111000011
1011111111000011
1011111111000011
1P11111111000011