0000000111011121
0110110110001101
0100010111011000
0000000000000000
01E0010111011E00
0110110110001101
0000000111011101
1010110011111001
1010110001110001
101011E000000001
1000111110001111
1010111110001111
101011E000000001
1010111001110011
P000000000000001
1111111111111111