1111111121111111
1111111000111111
1000000000000000
1010101010101E10
1E10001111100010
1011111000111110
1011100000001110
10000000000000E0
1011100000001110
1E11111000111110
1000011101110000
1000001101100000
1000001101100000
11000011P1100001
1001101101101100
100000000000000E