1100001111000011
1101001111011011
E000000000011011
11010011E0111011
1100001111100011
1101001110101011
0000000000000002
01111111101E1011
0001000111100011
0000000000111011
00E1000110111011
1111101100011011
1000101100010000
1010101110110000
1010000000110000
1P1111111111E000