E000000000001111
1111101111101111
1100001111101111
P000011E00000011
1100001101011011
111110110100E011
1100000001111011
1101111101E00002
1101111101101011
11011E110110101E
1100000000001010
1101111111101010
110111E011101010
1100000000001010
1111100001101010
1111110011100000