00E100010001E001
0111010001011101
0001000100010001
0100010001000101
00E1000100010001
0111111101111101
0111111101E01101
01P0000001000001
0111111111010101
01E0001111000001
0101000011011001
0101100011111111
0001000000001221
0101100010001E01
0101000010100001
0000001110000001