1210110110110101
0000000000000000
0000E00000000000
11111111111101E1
0000000000E10111
E110111111110000
11101E00111E011E
1110110110110111
1000000000000001
1001001001001001
1000000000000001
1000000000000001
1001001001001001
1000000000000001
1101001001001011
1101P01001001E11